0,0,0,0,0,0,0,0,0,0
0,0,0,0,0,0,0,0,0,0
0,0,0,0,0,0,0,0,0,0
0,E,E,E,S,0,0,0,0,0
0,N,0,0,S,0,0,0,0,0
0,N,0,0,S,0,0,0,0,0
0,N,W,W,W,0,0,0,0,0
0,P,0,0,0,0,0,0,0,0